"filename", "language", "Markdown", "JavaScript", "CSS", "HTML", "comment", "blank", "total"
"/Users/cdaloong/Documents/code/GitHub/blog-doc/Algorithm/算法学习.md", "Markdown", 1609, 0, 0, 0, 0, 168, 1777
"/Users/cdaloong/Documents/code/GitHub/blog-doc/Browser/WebAssembly.md", "Markdown", 47, 0, 0, 0, 0, 34, 81
"/Users/cdaloong/Documents/code/GitHub/blog-doc/CSS/CSS3学习.md", "Markdown", 378, 0, 0, 0, 0, 87, 465
"/Users/cdaloong/Documents/code/GitHub/blog-doc/Computer/网络学习.md", "Markdown", 468, 0, 0, 0, 0, 87, 555
"/Users/cdaloong/Documents/code/GitHub/blog-doc/HTML/HTML5学习.md", "Markdown", 568, 0, 0, 0, 0, 64, 632
"/Users/cdaloong/Documents/code/GitHub/blog-doc/HTML/HTNL+CSS基础学习.md", "Markdown", 1143, 0, 0, 0, 0, 421, 1564
"/Users/cdaloong/Documents/code/GitHub/blog-doc/JavaScript/ECMAScript.md", "Markdown", 30, 0, 0, 0, 0, 9, 39
"/Users/cdaloong/Documents/code/GitHub/blog-doc/JavaScript/ES6学习.md", "Markdown", 1757, 0, 0, 0, 0, 353, 2110
"/Users/cdaloong/Documents/code/GitHub/blog-doc/JavaScript/JS基础学习.md", "Markdown", 2786, 0, 0, 0, 12, 849, 3647
"/Users/cdaloong/Documents/code/GitHub/blog-doc/JavaScript/Math方法.md", "Markdown", 59, 0, 0, 0, 0, 50, 109
"/Users/cdaloong/Documents/code/GitHub/blog-doc/JavaScript/NodeJS学习.md", "Markdown", 209, 0, 0, 0, 0, 28, 237
"/Users/cdaloong/Documents/code/GitHub/blog-doc/JavaScript/js代码开发规范.md", "Markdown", 1591, 0, 0, 0, 0, 745, 2336
"/Users/cdaloong/Documents/code/GitHub/blog-doc/JavaScript/数组的方法.md", "Markdown", 2310, 0, 0, 0, 0, 68, 2378
"/Users/cdaloong/Documents/code/GitHub/blog-doc/Linux/Linux学习.md", "Markdown", 117, 0, 0, 0, 8, 33, 158
"/Users/cdaloong/Documents/code/GitHub/blog-doc/MiniProgram/支付宝小程序.md", "Markdown", 285, 0, 0, 0, 0, 20, 305
"/Users/cdaloong/Documents/code/GitHub/blog-doc/Module/git学习.md", "Markdown", 13, 0, 0, 0, 0, 0, 13
"/Users/cdaloong/Documents/code/GitHub/blog-doc/Module/webpack学习.md", "Markdown", 2317, 0, 0, 0, 0, 986, 3303
"/Users/cdaloong/Documents/code/GitHub/blog-doc/Module/包管理器学习.md", "Markdown", 531, 0, 0, 0, 0, 126, 657
"/Users/cdaloong/Documents/code/GitHub/blog-doc/Module/基于GitLabRunner的CICD部署流程.md", "Markdown", 494, 0, 0, 0, 0, 86, 580
"/Users/cdaloong/Documents/code/GitHub/blog-doc/Module/模块化学习.md", "Markdown", 369, 0, 0, 0, 0, 55, 424
"/Users/cdaloong/Documents/code/GitHub/blog-doc/MySQL/mysql学习.md", "Markdown", 778, 0, 0, 0, 0, 134, 912
"/Users/cdaloong/Documents/code/GitHub/blog-doc/README.md", "Markdown", 32, 0, 0, 0, 0, 36, 68
"/Users/cdaloong/Documents/code/GitHub/blog-doc/React/react学习.md", "Markdown", 3060, 0, 0, 0, 0, 264, 3324
"/Users/cdaloong/Documents/code/GitHub/blog-doc/Rust/Rust学习.md", "Markdown", 2508, 0, 0, 0, 0, 445, 2953
"/Users/cdaloong/Documents/code/GitHub/blog-doc/Static/docsify.min.js", "JavaScript", 0, 2, 0, 0, 7, 1, 10
"/Users/cdaloong/Documents/code/GitHub/blog-doc/Static/fonts/css.css", "CSS", 0, 0, 189, 0, 27, 1, 217
"/Users/cdaloong/Documents/code/GitHub/blog-doc/Static/fonts/font_1844225_yz2bwdnajp.css", "CSS", 0, 0, 30, 0, 0, 8, 38
"/Users/cdaloong/Documents/code/GitHub/blog-doc/Static/plugins/blueimp-md5@2.19.0.js", "JavaScript", 0, 1, 0, 0, 1, 0, 2
"/Users/cdaloong/Documents/code/GitHub/blog-doc/Static/plugins/catalog.js", "JavaScript", 0, 1, 0, 0, 0, 1, 2
"/Users/cdaloong/Documents/code/GitHub/blog-doc/Static/plugins/countable.js", "JavaScript", 0, 51, 0, 0, 6, 4, 61
"/Users/cdaloong/Documents/code/GitHub/blog-doc/Static/plugins/docsify-copy-code.min.js", "JavaScript", 0, 1, 0, 0, 8, 1, 10
"/Users/cdaloong/Documents/code/GitHub/blog-doc/Static/plugins/docsify-pagination.min.js", "JavaScript", 0, 1, 0, 0, 0, 0, 1
"/Users/cdaloong/Documents/code/GitHub/blog-doc/Static/plugins/docsify-sidebar-collapse.min.js", "JavaScript", 0, 1, 0, 0, 0, 0, 1
"/Users/cdaloong/Documents/code/GitHub/blog-doc/Static/plugins/emoji.min.js", "JavaScript", 0, 1, 0, 0, 0, 1, 2
"/Users/cdaloong/Documents/code/GitHub/blog-doc/Static/plugins/front-matter.min.js", "JavaScript", 0, 1, 0, 0, 0, 1, 2
"/Users/cdaloong/Documents/code/GitHub/blog-doc/Static/plugins/gitalk.min.js", "JavaScript", 0, 6, 0, 0, 29, 0, 35
"/Users/cdaloong/Documents/code/GitHub/blog-doc/Static/plugins/search.min.js", "JavaScript", 0, 1, 0, 0, 0, 1, 2
"/Users/cdaloong/Documents/code/GitHub/blog-doc/Static/plugins/zoom-image.min.js", "JavaScript", 0, 2, 0, 0, 1, 1, 4
"/Users/cdaloong/Documents/code/GitHub/blog-doc/Static/themes/gitalk.css", "CSS", 0, 0, 1117, 0, 15, 127, 1259
"/Users/cdaloong/Documents/code/GitHub/blog-doc/Static/themes/vue.min.css", "CSS", 0, 0, 1, 0, 0, 0, 1
"/Users/cdaloong/Documents/code/GitHub/blog-doc/Vue/vue2学习.md", "Markdown", 5795, 0, 0, 0, 0, 1766, 7561
"/Users/cdaloong/Documents/code/GitHub/blog-doc/_sidebar.md", "Markdown", 37, 0, 0, 0, 0, 13, 50
"/Users/cdaloong/Documents/code/GitHub/blog-doc/index.html", "HTML", 0, 0, 0, 97, 12, 4, 113
"Total", "-", 29291, 69, 1337, 97, 126, 7078, 37998